state,"Consent Decree, Settlement, or Other Agreement",Final Judgment,Objection by the Attorney General,PI
AK,1,0,0,0
AL,1,5,4,0
AR,2,2,0,0
AZ,1,1,2,0
CA,11,0,1,1
CO,0,2,0,0
FL,6,2,2,0
GA,8,2,15,2
HI,0,1,0,0
IA,0,0,1,0
IL,0,3,0,0
LA,2,1,14,1
MA,4,1,0,0
MI,3,0,0,0
MO,0,3,0,0
MS,4,7,11,0
MT,2,1,0,0
NC,0,1,7,1
ND,3,0,0,0
NE,1,1,0,0
NJ,2,0,0,0
NM,4,0,0,0
NV,0,0,0,1
NY,7,4,2,1
OH,3,1,0,0
PA,1,1,0,0
SC,1,1,15,0
SD,3,2,1,0
TN,1,1,0,0
TX,16,8,22,1
UT,0,1,0,0
VA,0,3,6,0
WA,2,1,0,0
WI,0,1,0,0
WY,0,1,0,0
